1111111111
100C0001E1
1000001101
10P1000001
1111111111