1111111111111111111111111111111111111111111111111
100C000100000000000000011000000100000000000000011
10000011010000000010000110000011010000000010E0011
10P10000000000000010000000010000000000C0001000011
1000000000000000001000000000000000000000001000011
1000100000010000000C00011000100000010000000C00011
1000001000000000000000000000001000000000000000011
1111111110000111111111000011111111000011100000111
1000000000000000001000000000000000000000001000011
1000100000010000000C00011000100000010000000C00011
1000001000000000000000011000001000000000000000011
1110000000000110000000000000000000000011110001111
1000001000000000000000000000001000000000000000011
1000011110000100000000000000000000000011100000111
1000000000000000001000000000000000000000001000011
1000100000010000000C00001000101110000010000000C01
1000001000000000000000011000001000000000000000011
1111111111111111111111111111111111111111111111111