111111111111111111111111
100C00010000000000000001
10000011010000000010E001
10P10000000000C000100001
100000000000000000100001
1000100000010000000C0001
100000100000000000000001
111111111111111111111111