1111111111111111111111111111111111111111111111111
100C000100000000000000011000000100000000000000001
10000011010000000010000110000011010000000010E0001
10P10000000000000010000000010000000000C0001000001
1000000000000000001000000000000000000000001000001
1000100000010000000C00011000100000010000000000001
1000001000000000000000000000001000000000000000001
1111111110000111111111000011111111000011100000101
1000000000000000001000000000000000000000001000001
1000100000010000000C00011000100000010000000C00001
1000001000000000000000011000001000000000000000001
1110000000000110000000000000000000000011110001101
1000001000000000000000000000001000000000000000001
100C011110000100000000000000000000000011100000101
1000000000000000001000000000000000000000001000001
1000100000010000000C00001000101110000010000000C01
1000001000000000000000011000001000000000000000001
1111111111111111111111111111111111111111111111111