111111111111111111111111
100000000000000000000001
100000110000000001C00001
100P00000000000001000001
100000010000000000000001
100000000000001000000001
100000000000000000000001
100000000111000000000001
100000000000000000000001
1010000000000001100E1001
1000C0000000000000000001
100000000000000000000001
111111111111111111111111
